39 22
111111111111111111111111111111111111111
172222000000000000000000000000000222271
122220000000000000000000000000000022221
122200000000000000000000000000000002221
122000000000000000000000000000000000221
100000000000000000000000000000000000001
100000000000000000000000000000000000001
100000000000000000000000000000000000001
122200000000000000000000000000000002221
122200000000000000000000000000000002221
182200000000000000000000000000000002281
122200000000000000000000000000000002221
122200000000000000000000000000000002221
100000000000000000000000000000000000001
100000000000000000000000000000000000001
100000000000000000000000000000000000001
100000000000000000000000000000000000001
122000000000000000000000000000000000221
122200000000000000000000000000000002221
122220000000000000000000000000000022221
172222000000000000000000000000000222271
111111111111111111111111111111111111111